First-Name	Last-Name	Email	Country
Whoopi	Daniel	amet@google.com	Turkey
Oren	Jefferson	nec.metus@hotmail.net	Chile
Judah	Golden	feugiat.lorem@protonmail.edu	Russia
Elmo	Aguirre	mi.fringilla.mi@outlook.net	Ukraine
Nayda	Rasmussen	donec.dignissim.magna@outlook.com	Peru
Uriel	Snyder	eu.euismod@google.com	Brazil
Channing	Stephens	neque.in@outlook.couk	Poland
Macon	Campos	quis@protonmail.couk	Italy
Mallory	Sandoval	bibendum.donec.felis@hotmail.couk	Ireland
George	Aguirre	mi.felis@google.ca	Canada
Zelda	Parrish	proin@aol.edu	CR
Lucian	Cox	donec@outlook.com	SK
Marvin	Howell	fames@aol.org	Netherlands
Dalton	Burks	curabitur.vel.lectus@hotmail.couk	Spain
Dustin	Ward	risus.donec@outlook.couk	Colombia
Vance	Ruiz	donec@outlook.org	Netherlands
Darius	Frazier	eros.non@hotmail.ca	US
Fritz	Cross	feugiat.sed.nec@aol.edu	NZ
Lysandra	Hogan	curabitur.dictum@hotmail.ca	US
Lester	Moses	sagittis.augue@google.net	NZ
Kelly	Berger	luctus@yahoo.couk	SK
Basia	Michael	pellentesque.sed.dictum@protonmail.ca	SK
Nathaniel	Warner	dolor.sit.amet@hotmail.org	Belgium
Norman	Doyle	ac.libero.nec@yahoo.ca	Ireland
Riley	Shannon	suspendisse.aliquet@yahoo.couk	Mexico
Phelan	Lara	pede.et.risus@aol.org	Brazil
Keely	Gilliam	blandit.at.nisi@google.couk	Australia
Brock	Martinez	non.leo.vivamus@aol.ca	Brazil
Briar	Church	ante.vivamus.non@icloud.net	Poland
Acton	Carson	sapien.molestie@protonmail.org	Singapore
Shaine	Manning	dignissim.lacus.aliquam@aol.edu	Peru
Ian	Browning	lacinia@google.net	Vietnam
Amaya	Acevedo	non@yahoo.ca	Nigeria
Lee	Williams	nascetur.ridiculus@aol.net	Belgium
Cody	Witt	tortor.integer.aliquam@google.com	Nigeria
Amy	Cox	pharetra.nam@outlook.couk	Turkey
Lillith	Jennings	etiam.vestibulum@outlook.com	China
Jamalia	Blair	sed.orci@protonmail.com	Singapore
John	Mathews	velit.sed.malesuada@google.com	US
Lani	Roman	nunc.mauris.elit@aol.net	Ireland
Edan	Vincent	nulla.eget.metus@aol.ca	Norway
Hiram	Landry	sit@hotmail.net	Brazil
Kane	Rollins	integer.vulputate@outlook.ca	Peru
Ori	Kerr	tincidunt.vehicula@protonmail.edu	Belgium
Marah	Osborne	hendrerit@protonmail.ca	Indonesia
Erich	Castillo	sem.nulla@hotmail.org	CR
Jacob	Alford	libero.est.congue@hotmail.org	Ukraine
Deborah	Hendricks	diam.nunc@yahoo.edu	Spain
Laurel	Buck	lectus.pede@aol.couk	China
Cameron	Keller	nunc.laoreet@yahoo.org	NZ
Nicholas	Jackson	neque.sed.eget@protonmail.net	Italy
Arsenio	Mclean	integer.vitae@hotmail.ca	France
Amity	Chavez	lacinia.orci@google.org	Pakistan
Rachel	Perkins	ipsum.non.arcu@yahoo.ca	Australia
Kalia	Coleman	dolor.sit@yahoo.edu	Colombia
Zenia	Schultz	facilisis.eget@hotmail.edu	Turkey
Carter	Brock	nibh@yahoo.com	Australia
Blossom	Snow	duis.cursus@yahoo.net	Colombia
Craig	Terry	magnis@aol.ca	Italy
Carson	Sellers	ante.lectus@protonmail.ca	Sweden
Maris	Christensen	est.vitae@hotmail.ca	CR
Finn	Rogers	cubilia.curae.phasellus@google.ca	Austria
Caesar	Jennings	ligula@google.com	Spain
Palmer	Oliver	tempor.augue@aol.net	SK
Cain	Blake	ipsum.ac@aol.edu	Peru
Jaime	Hubbard	et.rutrum@google.edu	Peru
Reese	Parks	libero.donec.consectetuer@outlook.com	Ukraine
Lamar	Mooney	luctus.sit.amet@google.couk	Indonesia
Elijah	Dotson	nulla.dignissim.maecenas@google.ca	Singapore
Susan	Mullins	amet@protonmail.org	Austria
Tamara	Hurst	cras.sed@icloud.couk	Poland
Ivana	Vega	sodales.at.velit@hotmail.org	Turkey
Marcia	Delaney	amet.nulla.donec@protonmail.com	Austria
Christopher	Holcomb	volutpat.nunc@hotmail.couk	UK
Zephania	Davenport	aenean@protonmail.ca	Philippines
Jescie	Beck	elit.elit@yahoo.net	CR
Miriam	Cotton	lectus@aol.org	Singapore
Walker	Hayes	dis.parturient@protonmail.edu	Australia
Kimberley	Lowery	molestie.dapibus.ligula@aol.org	Poland
Henry	Gamble	quisque.libero.lacus@google.ca	Chile
Francesca	Callahan	nunc.ac.mattis@icloud.couk	SA
Vielka	Schneider	odio.phasellus@outlook.edu	US
Mia	Sampson	est@yahoo.edu	Vietnam
Dean	Herrera	ullamcorper.eu.euismod@google.couk	Brazil
Fallon	Yates	aliquet.phasellus.fermentum@hotmail.edu	Nigeria
Armando	Howe	sit.amet@protonmail.org	SA
Ralph	Beck	augue.malesuada.malesuada@aol.edu	Brazil
Zena	Reilly	nulla.tincidunt@google.edu	Chile
Eleanor	Bruce	non.cursus@aol.org	India
Cain	Duffy	ante.vivamus@google.couk	India
Aphrodite	Humphrey	tincidunt.pede@aol.edu	Austria
Pascale	Perry	bibendum.sed@outlook.edu	Nigeria
Fletcher	Reyes	bibendum@protonmail.com	Vietnam
Lars	Lyons	imperdiet.ornare@google.com	UK
Sonia	Lambert	nisi.dictum@google.ca	Spain
Oliver	Mosley	lectus.convallis@aol.com	Spain
Lacy	Figueroa	mi.felis@google.net	Vietnam
Timon	Rowe	class.aptent@icloud.org	SA
Caleb	Poole	et@aol.net	Canada
Ulric	Rhodes	laoreet.libero@outlook.net	Sweden
